11111111111111111111111111111111111111111111111111111111111
1CCCCCCCCCCCCCCCCCCCCCCCCCCCCCCCCCCCCCCCCCCCCCCCCCCCCCCCCC1
1CCCCCCCCCCCCCCCCCC111111111CCCCCCCC111111111111111111CCCC1
1CCCPCCCCCCCCCCCC111111111CCCCCCCCC111CCCCCC11111111CCCCCC1
1CCCCCCCCCCCCCC111111111CCCCCCCCCCCC1CCCCCCCC11111111CCCCC1
1CCCCCCCCCC111111111CCCCCCCCCCCCCCCCCCCCC111111111CCCCCCCC1
1CCCCCCCCC111111111CCCCCCCCCCCCCCCCCCCCC11111111CCCCCCCCCC1
1CCCCCCCC111111111CCCCCCCCCCCCCCCCCCCC111111111CCCCCCCCCCC1
1CCCC111111111111111111111111111CCCC111111111CCCCCCCCCCCCC1
1CCCC111111111111111111111111111CCCC111111111CCCCCC11CCCCC1
1CCCC111111111111111111111111111CCCC111111111CCC11111CCCCC1
1CCCCCCCCCCCCCCCCCCCCCC111111111CCCC11111111111111111CCCCC1
1CCCCCCCCCCCCCCCCCCCCCC111111111CCCCCCCCCCCCCCCCCCCCCCCCCC1
1CCCCCCCCCCCCCCCCCCCCCC111111111CCCCCECCCCCCCCCCCCCCCCCCCC1
1CCCCCCCCCCCCCCCCCCCCCCCCCCCCCCCCCCCCCCCCCCCCCCCCCCCCCCCCC1
11111111111111111111111111111111111111111111111111111111111