11111111111111111111111111111111111
10010011111110011101111C11000000011
1000110001010C010000101001101010101
101110C0000100000000101001001011101
111100001100011000011001000C1101001
111000100000111100001100P0111100001
11010100100001100100100110000000001
11100011001C11111101010011000001001
1000100100C001000000010000001000011
10010000001101101101011001001010011
10000101001010100C10000000111001101
11010010010110101111000110001010001
11111100100001101101011001000111011
1010100110010000010110001101001E101
101010010111110100001110000C0100111
1111000111010C010001001010001100011
11111000010111101010100011000000011
1011C010010100001000011010000000001
110010000011011011000010000C1000101
11111111111111111111111111111111111