1111111111111
1YC1CCCCCCCY1
1CCCC11111C11
1PCY11YECCCY1
1111111111111