11111111111111111111
1110000110001000CC11
1C0CCC0C10CC101110C1
100110000CCC0110CC01
1C1011011C0C001CC101
10C000CC01011C0C0011
10001C00C100100110C1
10C111C0C001C00C1101
1111CC0CCCE01C011C01
1C001C0C1C0CCC0C1001
111C00C01C01C10P0111
11111111111111111111