11111111111111111111
10010000000C000C0001
10000111110011110001
1P0011E0000011100001
11111111111111111111