11111111111111111111111111111111111111111111111111111111111
10000000000000000000000000000000000000000000000000000000001
1000000000000000000CCCCCCCCC00000000CCCCCCCCCCCCCCCCC000001
1000P000000000000CCCCCCCCC000000000CCC000000CCCCCCCC0000001
100000000000000CCCCCCCCC000000000000C00000000CCCCCCCC000001
10000000000CCCCCCCCC000000000000000000000CCCCCCCCC000000001
1000000000CCCCCCCCC000000000000000000000CCCCCCCC00000000001
100000000CCCCCCCCC00000000000000000000CCCCCCCCC000000000001
10000CCCCCCCCCCCCCCCCCCCCCCCCCCC0000CCCCCCCCC00000000000001
10000CCCCCCCCCCCCCCCCCCCCCCCCCCC0000CCCCCCCCC000000CC000001
10000CCCCCCCCCCCCCCCCCCCCCCCCCCC0000CCCCCCCCC000CCCCC000001
10000000000000000000000CCCCCCCCC0000CCCCCCCCCCCCCCCCC000001
10000000000000000000000CCCCCCCCC000000000000000000000000001
10000000000000000000000CCCCCCCCC00000000000000000000000E001
10000000000000000000000000000000000000000000000000000000001
11111111111111111111111111111111111111111111111111111111111