1111111111111111111111111111
1CCCCCCCCCCCC11CCCCCCCCCCCC1
1C1111C11111C11C11111C1111C1
1C1111C11111C11C11111C1111C1
1C1111C11111C11C11111C1111C1
1CCCCCCCCCCCCCCCCCCCCCCCCCC1
1C1111C11C11111111C11C1111C1
1C1111C11C11111111C11C1111C1
1CCCCCC11CCCC11CCCC11CCCCCC1
1CCCCCC11CCCC11CCCC11CCCCCC1
1C1111C11CCCCCCCCCC11C1111C1
1C1111C11C11100111C11C1111C1
1CCCCCC11C10000001C11CCCCCC1
1CCCCCC11C1E0000P1C11CCCCCC1
1C1111C11C11111111C11C1111C1
1C1111C11CCCCCCCCCC11C1111C1
1CCCCCC11CCCC11CCCC11CCCCCC1
1CCCCCC11CCCC11CCCC11CCCCCC1
1C1111C11C11111111C11C1111C1
1C1111C11C11111111C11C1111C1
1CCCCCCCCCCCCCCCCCCCCCCCCCC1
1C1111C11111C11C11111C1111C1
1C1111C11111C11C11111C1111C1
1C1111C11111C11C11111C1111C1
1CCCCCCCCCCCC11CCCCCCCCCCCC1
1111111111111111111111111111