11111111111111111111
1P111111111111111111
10111111111111111111
1000000000000C000111
11111111111111000111
10000000000001000111
10111111111111000111
10111111111111000111
101000000000000E0111
11111111111111111111