1111111111111111111111111111111111
1E00Y0000000000C00000C00000Y000001
1010010100100000101001000000010101
1P10010010101010001001000000010101
10000000YC00C0000000000000000000C1
1111111111111111111111111111111111