1111111111
1P00000101
1000000101
1000C00101
1000000101
1000000101
10000001E1
1111111111
1111111111
