1111111111
1C001000C1
10P0100001
1011111101
1000100101
1010100001
1010000101
1010110111
1E10100001
1111111111